1111111111111111111111111111111111111111111111111111111111111111111111111111111111111
1P000000C000111111111111110000000000000C000000000000000000011111111111111111111111111
1111100000000000000000000111111100000000000000000000000000011111111111111111111111111
1000110000000000000000000000000110000000000000000000000000011111111111111111111111111
1000000000000111110000000000000000000000000111111100000000011111111111111111111111111
1000000000000000000000000000000000000000000000000110000000011111111111111111111111111
1000000000000000000000000000000000000000000000000000000000011111111111111111111111111
1000000000000000000000000000000000000000000000000000000000011111111111111111111111111
1111100000000000000000000000000000000000000000000000000000011111111111111111111111111
1000111110000000000000000000000000000000000000000000000000011111111111111111111111111
1000000000000000000000000000000000000000000000000000000000011111111111111111111111111
1000000000000000000000000000000000000000000000000000000000011111111111111111111111111
1000000000000000000000000000000000000000000000000000000000011111111111111111111111111
1000000000000000000000000000000000000000000000000000000000011111111111111111111111111
1000000000000000000000000000000000000000000000000000000000011111111111111111111111111
1000000000000000000000000000000000000000000000000000000000011111111111111111111111111
1000000000000000000000000000000000000000000000000000000000011111111111111111111111111
1000000000000000000000000000000000000000000000000000000000011111111111111111111111111
1000000000000000000000000000000000000000000000000000000000011111111111111111111111111
1000000000000000000000000000000000000000000000000000000000011111111111111111111111111
1000000000000000000000000000000000000000000000000000000000011111111111111111111111111
1000000000000000000000000000000000000000000000000000000000011111111111111111111111111
1000000000000000000000000000000000000000000000000000000000011111111111111111111111111
1000000000000000000000000000000000000000000000000000000000011111111111111111111111111
1111100000000000000000000000000000000000000000000000000000011111111111111111111111111
1000111110000000000000000000000000000000000000000000000000011111111111111111111111111
1000000000000000000000000000000000000000000000000000000000011111111111111111111111111
1000000000000000000000000000000000000000000000000000000000011111111111111111111111111
100000000000000000000C000000000000000000000000000000000000011111111111111111111111111
100000000000000000000000000000000000000000000000000000000E111111111111111111111111111
1111111111111111111111111111111111111111111111111111111111111111111111111111111111111
