11111111111111111111
1P000000000000001111
10000000000000000001
11100011100000011111
1010001110000000C001
10100011100000011111
100000C0000000000001
10000000000000000001
1000000C000000011111
11110000000000011111
1111000000000C000001
1C000000000000000001
11110000000000000001
111100C0000000111111
1010000000000C111111
10000011000000000001
10000011000000000001
1C0000000000000011C1
100000000000000011E1
11111111111111111111
