111111111
10000P001
1E00C00d1
111111111
