11111111
100000P1
10000001
10000001
100000E1
11111111
