11111111
10000000
1P000001
100000E1
11111111
